2 2 2 2 2 2 2 2 2 2 2 2 2 2 2
2 0 0 0 0 0 0 0 0 0 0 0 0 0 2
2 0 1 0 1 0 1 0 1 0 1 0 1 0 2
2 3 3 3 3 3 3 3 3 3 3 3 3 3 2
2 3 1 3 1 3 1 3 1 3 1 3 1 3 2
2 4 4 4 4 4 4 4 4 4 4 4 4 4 2
2 0 1 0 1 0 1 0 1 0 1 0 1 0 2
2 4 4 4 4 4 4 4 4 4 4 4 4 4 2
2 5 1 5 1 5 1 5 1 5 1 5 1 5 2
2 5 5 5 5 5 5 5 5 5 5 5 5 5 2
2 0 1 0 1 0 1 0 1 0 1 0 1 0 2
2 0 0 0 0 0 0 0 0 0 0 0 0 0 2
2 2 2 2 2 2 2 2 2 2 2 2 2 2 2