12 12 12 12 12 12 12 12 12 12 12 12 12 12 12,
12 10 10 10 10 10 10 10 10 10 10 10 10 10 12,
12 10 11 10 11 10 11 10 11 10 11 10 11 10 12,
12 13 11 13 13 13 13 13 13 13 13 13 13 13 12,
12 13 11 13 11 11 11 11 11 11 11 13 11 13 12,
12 14 11 14 14 14 14 14 14 14 11 14 14 14 12,
12 10 11 10 11 10 11 10 11 10 11 10 11 10 12,
12 14 11 14 14 14 14 14 14 14 11 14 14 14 12,
12 15 11 15 11 15 11 15 11 11 11 15 11 15 12,
12 15 11 15 15 15 15 15 15 15 15 15 15 15 12,
12 10 11 10 11 10 11 10 11 10 11 10 11 10 12,
12 10 10 10 10 10 10 10 10 10 10 10 10 10 12,
12 12 12 12 12 12 12 12 12 12 12 12 12 12 12