20 1 1 1 1 1 1 1 1 1 1 1 1 1 20,
1 19 19 19 19 19 19 19 19 19 19 19 19 19 1,
1 19 20 19 20 19 20 19 20 19 20 19 20 19 1,
1 16 20 16 16 16 16 16 16 16 16 16 16 16 1,
1 16 20 16 20 20 20 20 20 20 20 16 20 16 1,
1 17 20 17 17 17 17 17 17 17 20 17 17 17 1,
1 19 20 19 20 19 20 19 20 19 20 19 20 19 1,
1 17 20 17 17 17 17 17 17 17 20 17 17 17 1,
1 18 20 18 20 18 20 18 20 20 20 18 20 18 1,
1 18 20 18 18 18 18 18 18 18 18 18 18 18 1,
1 19 20 19 20 19 20 19 20 19 20 19 20 19 1,
1 19 19 19 19 19 19 19 19 19 19 19 19 19 1,
20 1 1 1 21 1 1 22 1 1 21 1 1 1 20